11 24
########################
#*                     #
# ######################
#                      #
# ######################
#                      #
# ######################
#                      # 
# ###################### 
#                      #
########################