9 20
####################
#*                 #
#                  #
#                  #
#      ######      #
#                  #
#                  #
#                  #
####################